22 16 16 16 16 16 16 16 16 16 16 16 16 16 16 23 22 16 16 16 16 16 16 16 16 16 16 16 16 16 16 16 16 16 16 16 16 16 16 16 16 16 16 16 16 16 16 16 16 23
18 14 14 14 14 14 14 14 14 14 14 14 14 14 14 19 18 12 12 12 12 12 12 12 12 12 12 12 12 12 19 18 12 12 12 12 12 12 12 12 12 12 12 12 12 12 12 12 12 19
18 17 14 14 14 14 14 14 14 14 14 14 14 14 14 19 18 12 12 12 12 12 12 12 12 12 12 12 12 12 10 10 12 12 12 12 12 12 12 12 12 12 12 12 12 12 12 12 12 19
18 14 14 14 14 14 14 14 14 14 14 14 14 14 14 19 18 12 12 12 12 12 12 12 12 12 12 12 12 12 10 10 12 12 12 12 12 12 12 12 12 12 12 12 12 12 12 12 12 19
18 14 14 14 14 14 14 14 14 14 14 14 14 14 14 10 10 12 12 12 12 12 12 12 12 12 12 12 12 12 19 18 12 12 12 12 12 12 12 12 12 12 12 12 12 12 12 12 12 19
18 14 14 14 14 14 14 14 14 14 14 14 14 14 14 19 18 12 12 12 12 12 12 12 12 12 12 12 12 12 19 18 12 12 12 12 12 12 12 12 12 12 12 12 12 12 12 12 12 19
18 14 14 14 14 14 14 14 14 14 14 14 14 14 14 19 18 12 12 12 12 12 12 12 12 12 12 12 12 12 19 18 12 12 12 12 12 12 12 12 12 12 12 12 12 12 12 12 12 19
18 14 14 14 14 14 14 14 14 14 14 14 14 14 14 19 18 12 12 12 12 12 12 12 12 12 12 12 12 12 19 18 12 12 12 12 12 12 12 12 12 12 12 12 12 12 12 12 12 19
20 17 17 17 17 17 17 12 17 17 17 17 17 17 17 21 20 17 17 17 17 17 17 17 17 17 17 17 17 17 21 18 12 12 12 12 12 12 12 12 12 12 12 12 12 12 12 12 12 19
22 16 16 16 16 16 16 12 16 16 16 16 16 16 16 16 16 16 16 16 16 16 16 16 16 16 16 16 16 16 23 18 12 12 12 12 12 12 12 12 12 12 12 12 12 12 12 12 12 19
18 15 15 15 15 10 12 12 12 26 26 24 24 25 24 25 25 25 26 26 12 12 12 12 12 12 12 12 12 12 19 18 12 12 12 12 12 12 12 12 12 12 12 12 12 12 12 12 12 19
18 15 10 10 10 12 12 12 12 12 26 26 24 24 24 25 25 26 26 12 12 12 12 12 12 12 12 12 12 12 12 10 12 12 12 12 12 12 12 12 12 12 12 12 12 12 12 12 12 19
18 15 10 12 12 12 12 12 12 12 12 26 26 26 25 24 26 26 12 12 12 12 12 12 12 12 12 12 12 12 12 10 12 12 12 12 12 12 12 12 12 12 12 12 12 12 12 12 12 19
18 10 12 12 12 12 12 12 12 12 12 12 26 26 26 26 26 12 12 12 12 12 12 12 12 12 12 12 12 12 19 18 12 12 12 12 12 12 12 12 12 12 12 12 12 12 12 12 12 19
18 12 12 12 12 12 12 12 12 12 12 12 12 12 12 12 12 12 12 12 12 12 12 12 12 12 12 12 10 10 19 18 12 12 12 12 12 12 12 12 12 12 12 12 12 12 12 12 12 19
18 12 12 12 12 12 12 12 12 12 12 12 12 12 12 12 12 12 12 12 12 12 12 12 12 12 12 10 15 15 19 18 12 12 12 12 12 12 12 12 12 12 12 12 12 12 12 12 12 19
18 12 12 12 12 12 12 12 12 12 12 12 12 12 12 12 12 12 12 12 12 12 12 12 12 12 10 15 15 15 19 18 12 12 12 12 12 12 12 12 12 12 12 12 12 12 12 12 12 19
20 17 17 17 17 17 17 17 17 10 10 10 10 17 17 17 17 17 17 17 17 17 17 17 17 17 17 17 17 17 21 20 17 17 17 17 17 17 17 17 17 17 17 17 17 17 17 17 17 21
22 16 16 16 16 16 16 16 16 10 10 10 10 16 16 16 16 16 16 16 16 16 16 16 16 16 16 16 16 16 16 16 16 16 16 16 16 16 16 16 16 16 16 16 16 16 16 16 16 23
18 12 12 12 12 12 12 12 12 12 14 14 12 12 12 12 12 12 12 12 12 12 12 12 12 12 12 12 12 12 12 12 12 12 12 12 12 12 12 12 12 12 12 12 12 12 12 12 12 19
18 12 12 12 12 12 12 12 12 12 14 14 12 12 12 12 12 12 12 12 12 12 12 12 12 12 12 12 12 12 12 12 12 12 12 12 12 12 12 12 12 12 12 12 12 12 12 12 12 19
18 12 12 12 12 12 12 12 12 12 14 14 12 12 12 12 12 12 12 12 12 12 12 12 12 12 12 12 12 12 12 12 12 12 12 12 12 12 12 12 12 12 12 12 12 12 12 12 12 19
18 12 12 12 12 12 12 12 12 12 14 14 12 12 12 12 12 12 12 12 12 12 12 12 12 12 12 12 12 12 12 12 12 12 12 12 12 12 12 12 12 12 12 12 12 12 12 12 12 19
18 12 12 12 12 12 12 12 12 12 14 14 12 12 12 12 12 12 12 12 12 12 12 12 12 12 12 12 12 12 12 12 12 12 12 12 12 12 12 12 12 12 12 12 12 12 12 12 12 19
18 12 12 12 12 12 12 12 12 12 14 14 12 12 12 12 12 12 12 12 12 12 12 12 12 12 12 12 12 12 12 12 12 12 12 12 12 12 12 12 12 12 12 12 12 12 12 12 12 19
18 12 12 12 12 12 12 12 12 12 14 14 12 12 12 12 12 12 12 12 12 12 12 12 12 12 12 12 12 12 12 12 12 12 12 12 12 12 12 12 12 12 12 12 12 12 12 12 12 19
18 12 12 12 12 12 12 12 12 12 14 14 12 12 12 12 12 12 12 12 12 12 12 12 12 12 12 12 12 12 12 12 12 12 12 12 12 12 12 12 12 12 12 12 12 12 12 12 12 19
18 12 12 12 12 12 12 12 12 12 14 14 12 12 12 12 12 12 12 12 12 12 12 12 12 12 10 10 10 10 10 10 10 10 10 12 12 12 12 12 12 12 12 12 12 12 12 12 12 19
18 12 12 12 12 12 12 12 12 12 14 14 12 12 12 12 12 12 12 12 12 12 12 12 12 12 10 13 13 13 13 13 13 13 10 12 12 12 12 12 12 12 12 12 12 12 12 12 12 19
18 12 12 12 12 12 12 12 12 12 14 14 12 12 12 12 12 12 12 12 12 12 12 12 12 12 10 13 15 15 15 15 15 13 10 12 12 12 12 12 12 12 12 12 12 12 12 12 12 19
18 12 12 12 12 12 12 12 12 12 14 14 12 12 12 12 12 12 12 12 12 12 12 12 12 12 10 13 13 13 13 13 13 13 10 12 12 12 12 12 12 12 12 12 12 12 12 12 12 19
18 12 12 12 12 12 12 12 12 12 14 14 12 12 12 12 12 12 12 12 12 12 12 12 12 12 10 10 10 10 10 10 10 10 10 12 12 12 12 12 12 12 12 12 12 12 12 12 12 19
18 12 12 12 12 12 12 12 12 12 14 14 12 12 12 12 12 12 12 12 12 12 12 12 12 12 12 12 12 12 12 12 12 12 12 12 12 12 12 12 12 12 12 12 12 12 12 26 26 19
18 12 12 12 12 12 12 12 12 12 14 14 12 12 12 12 12 12 12 12 12 12 12 12 12 12 12 12 12 12 12 12 12 12 12 12 12 12 12 12 12 12 12 12 12 26 26 26 26 19
18 12 12 12 12 12 12 12 12 12 14 14 12 12 12 12 12 12 12 12 12 12 12 12 12 12 12 12 12 12 12 12 12 12 12 12 12 12 12 12 12 12 12 26 26 26 26 26 26 19
18 12 12 12 12 12 12 12 12 12 14 14 12 12 12 12 12 12 12 12 12 12 12 12 12 12 12 12 12 12 12 12 12 12 12 12 12 12 12 12 12 26 26 26 26 26 26 26 26 19
18 12 12 12 12 12 12 12 12 12 14 14 12 12 12 12 12 12 12 12 12 12 12 12 12 12 12 12 12 12 12 12 12 12 12 12 12 12 12 12 26 26 26 26 26 26 26 26 26 19
18 12 12 12 12 12 12 12 12 12 14 14 12 12 12 12 12 12 12 12 12 12 12 12 12 12 12 12 12 12 12 12 12 12 12 12 12 26 26 26 26 26 26 26 26 26 26 25 24 19
18 12 12 12 12 12 12 12 12 12 14 14 12 12 12 12 12 12 12 12 12 12 12 12 12 12 12 12 12 12 12 12 12 12 26 26 26 26 26 26 26 26 26 26 25 25 24 24 25 19
18 12 12 12 12 12 12 12 12 12 14 14 12 12 12 12 12 12 12 12 12 12 12 12 12 12 12 12 12 12 12 12 12 26 26 26 26 26 26 26 26 26 26 25 25 25 24 25 25 19
18 12 12 12 12 12 12 12 12 12 14 14 12 12 12 12 12 12 12 12 12 12 12 12 12 12 12 12 12 12 12 12 26 26 26 26 26 26 26 26 26 26 25 25 25 24 24 25 25 19
18 12 12 12 12 12 12 12 12 12 14 14 12 12 12 12 12 12 12 12 12 12 12 12 12 12 12 12 12 12 26 26 26 26 26 26 26 26 25 25 25 25 25 25 25 25 25 25 25 19
18 12 12 12 12 12 12 12 12 12 14 14 12 12 12 12 12 12 12 12 12 12 12 12 12 12 12 26 26 26 26 26 26 26 26 24 24 24 25 25 25 24 25 25 24 24 25 25 25 19
18 12 12 12 12 12 12 12 12 12 14 14 12 12 12 12 12 12 12 12 12 12 12 12 12 12 12 26 26 26 26 26 26 26 25 25 24 24 25 25 25 24 25 25 25 25 25 25 25 19
18 12 12 12 12 12 12 12 12 12 14 14 12 12 12 12 12 12 12 12 12 12 12 12 12 12 26 26 26 26 26 26 25 24 24 24 24 25 25 25 25 24 25 25 25 25 25 25 25 19
18 12 12 12 12 12 12 12 12 12 14 14 12 12 12 12 12 12 12 12 12 12 12 12 12 26 26 26 26 26 26 25 24 25 25 24 25 25 25 25 24 25 25 25 25 25 24 25 25 19
18 12 12 12 12 12 12 12 12 12 14 14 12 12 12 12 12 12 12 12 12 12 12 12 12 26 26 26 26 26 26 25 24 25 25 24 25 25 25 25 24 25 25 25 24 24 24 25 25 19
18 12 12 12 12 12 12 12 12 12 14 14 12 12 12 12 12 12 12 12 12 12 12 12 26 26 26 26 26 26 25 24 24 25 25 24 24 25 25 24 24 25 25 24 24 25 25 25 25 19
18 12 12 12 12 12 12 12 12 12 14 14 12 12 12 12 12 12 12 12 12 12 12 12 26 26 26 26 24 25 25 24 24 25 25 25 25 25 25 25 25 25 25 25 25 25 25 25 25 19
20 17 17 17 17 17 17 17 17 17 17 17 17 17 17 17 17 17 17 17 17 17 17 17 17 17 17 17 17 17 17 17 17 17 17 17 17 17 17 17 17 17 17 17 17 17 17 17 17 21